10
8
-CCCCCC-
--..----
-..-----
-C----.C
-..---C-
-..---.-
-.----..
<......-
-...C.--
-CCC..--
