15
30
-----------------C...------.--
--..........................--
--.---------.-----------.-----
--....-...--.---.CC.----.-----
-----.-.-.--.-----------....--
-----...-.--.--.--..C------.--
------------.-----.C.------.--
-----........--C--...------.--
.C....------..----...------.--
--.--........-----.--------.--
--.---------------..-----..C..
<..-----.....C......-----.----
--.---.-.------.---------.----
--.......------.---------.----
--.CCCCC.----------------C----